##################
#......#.........#
#..P.............#
#................#
#......#.........#
##################
