########
#......#
#..P...#
#......#
########
